###########
#### ######
###  ###  #
## @      #
#   A@ #  #
### @###  #
###  #oo  #
### ##o# ##
##      ###
##     ####
###########