    #####   #####    
    #   #   #   #    
  ###   #####   ###  
  # o@o@o #  @o@  #  
### @o@o@ #o@o@o@o###
#  @o@o@o@ @o@o@o@  #
#  o@o@o@o o@o@o@o  #
#  @o@o@o@ @o@o@o@  #
### @o@o@ #o@o@o@.###
  # o@o@o o  @o@  #  
  ###   #oAo#   ###  
  #  @o@  o o@o@o #  
###o@o@o@o# @o@o@ ###
#  @o@o@o@ @o@o@o@  #
#  o@o@o@o o@o@o@o  #
#  @o@o@o@ @o@o@o@  #
###o@o@o@o# @o@o@ ###
  #  @o@  # o@o@o #  
  ###   #####   ###  
    #   #   #   #    
    #####   #####    