#################################
#  A           #            #   #
# ########## ######### #### ### #
# #  #                 #      # #
# # ######################### # #
# # #       #               # # #
# # # ####### ###### ###### # # #
# # #   #o@o    @       # # # # #
# # # # ######## ######## # # # #
# # # # #               # # #   #
# # # # # ##### ####### # # ### #
# # # # ###           # # # # # #
# # # # # # ######### ### #   # #
# # # # # # #       # # # # # ###
# # # # # #   ##### # # # # # # #
# # # # # # # #o    # # # # # # #
# # # #   # # #@# # # #   # # # #
# # ### # # # # # # # # # # # # #
# # # # # # # #   # # # # # # # #
# # #   # # # # ### # # # # # # #
# ### # # # #       #   # # # # #
# # # # # ###### ###### # # # # #
# # # # # #           # # # # # #
# # # # ############### # # # # #
# # # # #               # # # # #
#   # # ########## ###### # #   #
# # #              #      # # # #
# # # ######## ############ # # #
# # # #                   # # # #
# # ######################### # #
# #                         # # #
# ######## ################ ### #
#  #              #             #
#################################