#########
# A   @o#
#   @   #
# @@    #
# ooo   #
#       #
#########