############
#      A   #
##### #### #
#o@o     @ #
######### ##
#  ##   #  #
#   @ #    #
#o###   #  #
############