###############
#ooooooooooooo#
#@@@@@@@@@@@@@#
#             #
####### #######
      # #      
      #A#      
      # #      
      # #      
####### #######
#             #
#@@@@@@@@@@@@@#
#ooooooooooooo#
###############